1 6 628 4215 2503 1322 4244 4250
1 4 4250 1280 1365 1795
1 10 1795 3036 4369 2698 2435 4361 2544 4399 3165 1360
1 8 1360 2894 4468 1870 4523 2313 4562 3189
1 7 3189 638 4563 2397 4536 3548 4478
1 5 3189 4609 14 4673 3106
1 7 3106 4673 4005 2077 4655 3967 2238
1 5 3106 4725 2417 4787 4798
1 8 4798 1038 4791 201 1058 4799 1396 1226
1 4 1226 4818 1021 4779
1 7 1795 3102 3862 1716 4442 362 2656
1 5 3456 549 1059 1896 469
1 3 469 4625 1841
1 5 1841 1924 4708 4728 3333
1 5 1841 4679 4672 4699 4721
1 7 2656 4526 2821 4551 88 4572 469
1 4 3498 3982 2500 4932
1 3 3333 1403 3498
1 4 4932 2500 4929 1528
1 6 1528 4933 2679 4930 1473 4966
1 4 4966 2035 2091 395
1 4 395 4869 2234 1866
1 5 395 2430 3424 4874 845
1 4 845 4794 1334 1844
1 4 845 1116 4843 178
1 4 178 2108 2059 4917
1 4 4917 2365 1003 2461
1 4 1528 3814 3751 280
1 5 280 2463 3228 3383 1980
1 4 280 5028 2601 5042
1 3 5042 5022 938
1 4 938 4995 1441 4993
1 4 4993 2158 2628 2884
1 6 2884 1431 4970 114 3647 2461
1 6 2884 5031 596 985 1278 5080
1 7 5080 97 2755 3976 964 2458 1097
1 8 5080 5097 3914 5123 914 1158 1922 5182
1 3 5042 3159 3436
1 6 3436 3611 5106 2885 3357 2643
1 4 1980 5014 5037 1991
1 6 1991 2649 3217 601 3708 106
1 6 106 3506 4925 946 4891 1671
1 7 1671 4836 2791 2555 3158 830 4677
1 7 4677 830 668 2489 270 2179 4637
1 5 4677 1404 590 2668 2428
1 5 2428 1593 4564 1015 2166
1 6 2428 4568 1773 4539 3702 372
1 7 1671 4863 1759 259 568 4827 899
1 8 899 2620 3421 360 1224 627 3998 3916
1 4 899 4796 786 4733
1 3 4733 2760 2987
1 9 2987 4780 1935 4847 1304 2598 4047 4994 2011
1 4 2011 1472 5000 68
1 7 2011 3273 2115 5074 582 2341 967
1 6 967 5129 2190 3830 5157 1950
1 8 1950 5157 3744 5178 1831 2325 5205 1348
1 4 1348 2216 2936 5176
1 5 5176 482 3624 1113 456
1 6 1348 5219 2277 5242 1156 5238
1 4 5238 1168 3001 171
1 7 171 392 2759 5235 3710 853 2868
1 6 171 1223 2907 693 5282 1710
1 5 1710 3188 5307 1633 2983
1 4 5238 1740 1066 719
1 5 719 2069 5311 2215 5333
1 7 2868 5222 531 923 5245 1162 5263
1 6 2983 1206 3693 1736 1801 5335
1 4 5335 2774 3121 566
1 5 5335 5331 1609 5337 435
1 6 5335 2454 1470 5296 1836 5263
1 3 435 5320 3857
1 3 3857 2521 2269
1 5 1524 5257 2202 73 3122
1 6 3122 5262 3220 5286 1031 193
1 6 193 1563 1001 2146 4029 3952
1 10 3952 3019 401 3080 528 5329 2447 5314 2841 5315
1 7 3952 867 5318 5310 3787 3513 5277
1 7 5315 968 5289 3056 484 3398 2110
1 8 5277 5265 2436 3553 5230 5214 5204 3084
1 6 3084 2031 5163 3778 2719 1122
1 10 2110 5200 3646 1639 912 5138 1720 196 2053 5067
1 5 5067 3707 859 1946 2286
1 7 1122 5115 3884 1147 1131 408 2728
1 4 5067 2797 2966 721
1 3 721 1946 2286
1 7 2286 4961 174 65 2254 4839 1806
1 4 721 4988 2998 4952 
1 6 4952 1574 757 2209 1984 1420
1 4 1420 4924 4945 4962
1 6 2728 4009 5046 5023 346 4962
1 9 2728 138 5077 5082 5059 2098 3280 2707 5044
1 6 4952 3152 768 4025 3605 2128
1 4 5044 3471 3619 4996
1 4 4996 1932 5024 1674
1 6 4996 3938 506 4913 3416 2957
1 8 2957 2516 977 2067 3803 2080 1264 4872
1 8 4872 4842 4812 2531 4747 1341 3810 3691
1 4 3691 647 1995 1766
1 10 3691 4663 3765 317 4706 732 4682 102 3790 812
1 7 3691 3612 4594 424 3567 4537 2345
1 8 2957 137 2540 4801 1542 4749 788 2075
1 6 2075 379 2820 3860 1894 1051
1 5 1051 1626 1253 4592 1647
1 8 2075 4036 2130 4745 947 127 1326 4875
1 11 4875 3847 4883 1851 4866 3890 4850 363 3853 4803 1399
1 4 1399 4740 337 4693
1 7 1399 3964 3785 1968 4852 1754 2304
1 9 1399 4803 4833 4031 3856 1291 4958 290 1135
1 12 4693 1763 316 343 4650 1084 2323 4598 2211 2446 4559 1500
1 6 1500 4529 2828 4471 656 4460
1 6 1766 517 52 3448 886 4470
1 6 2345 3103 9 2258 4443 3531
1 4 3531 2278 3687 2042
1 7 3531 1854 2096 4375 2312 4333 125
1 5 125 2412 4371 4388 4406
1 6 4406 38 716 4362 3893 3852
1 5 3852 3312 2319 2929 4242
1 6 4242 2631 4220 1 2255 1959
1 7 1959 1901 4206 848 1100 4257 4266
1 9 4242 3144 4207 4186 1931 4138 4122 3387 1370
1 4 1370 3937 576 4024
1 6 1370 1778 3808 1129 546 4128
1 6 4128 4145 2493 2029 4208 4233
1 3 4233 2739 4307
1 5 4307 751 4348 4359 421
1 7 421 3573 1392 4422 4441 3999 4470
1 5 4307 3462 1507 1493 2001
1 5 2001 2024 1448 1492 3539
1 4 3539 4007 1655 1351
1 3 1351 3957 3308
1 8 3308 4212 3571 3783 1737 4144 4127 1000
1 4 1000 2408 4165 713
1 6 3539 4355 3910 449 331 4460
1 4 2065 2394 3351 2141
1 6 2141 3368 4270 3516 3149 604
1 4 4158 361 3988 604
1 4 4158 4156 2297 4161
1 5 4158 2092 2114 3173 4101
1 7 1270 2547 672 4142 3299 4107 811
2 5 811 1268 4066 1624 2630
1 6 811 4112 2676 210 3684 4159
1 6 4159 4174 3973 4204 3014 236
1 8 4250 4222 4232 1463 261 4200 1033 1270
1 6 10 2961 1121 357 4524 3343
1 5 10 4429 4421 84 1558
1 5 1558 1792 4497 2752 962
1 9 962 2189 4622 2585 4675 2423 2621 359 4779
1 7 10 2744 300 2520 2419 1695 2969
1 10 2969 1695 3204 765 3379 332 3380 4163 3854 2999
1 8 3598 1733 5551 3882 5595 1324 1267 905
1 6 3598 1733 5525 5522 1549 1046
1 10 1046 1234 1455 5620 2746 1890 118 3283 3218 2559
1 5 905 1837 982 1246 5844
1 7 5844 5866 3298 2722 5966 839 6014
1 8 2559 5852 4023 5923 419 5966 839 6014
1 5 473 2709 5905 3715 5844
1 8 473 5994 3472 2832 2778 1846 1610 6117
1 7 6117 1610 2519 1832 6161 6172 1048
1 6 1048 6193 6216 2837 6221 1981
1 5 1981 2763 6260 471 3024
1 4 3024 471 6287 1136
1 4 1136 1707 2052 6296
1 4 6296 739 6316 6323
1 6 6323 1212 6319 1916 166 2638
1 4 3317 6264 927 6296
1 5 6150 1004 6188 1825 3317
1 5 1981 2979 443 6197 3292
1 5 3292 6152 1165 6108 963
1 4 963 6088 6075 3364
1 6 3364 1738 6097 103 2400 6150
1 6 6150 6131 521 1447 6035 3945
1 4 387 5925 973 3945
1 4 387 5838 1417 2152
1 7 2152 1075 479 1660 5819 3249 5798
1 6 5798 3221 5753 5730 3360 3082
1 6 2594 3704 2487 1596 151 3082
1 6 2152 2495 1618 1511 5612 2594
1 4 2594 3081 826 5472
1 6 2594 2121 5556 5530 2533 5493
1 4 5493 1241 3694 172
1 10 172 648 1112 5560 3700 1197 2124 1395 3154 444
1 5 444 5646 345 5662 2848
1 6 3142 1516 314 5726 5699 2848
1 5 3142 1595 1020 5738 5725
1 5 1874 5933 2009 1080 3142
1 5 1874 6007 324 6036 999
1 3 999 3968 3230
1 5 3230 6137 623 6168 1969
1 5 1969 6158 1436 6131 6150
1 6 1969 6168 2135 6206 499 6247
1 6 6261 1880 6255 2064 499 6247
1 5 6309 1930 2809 6276 6261
1 5 3317 6251 6241 584 6261
1 7 6247 6240 626 6229 841 6230 1741
1 5 1503 1927 448 6209 1741
1 5 1503 2608 1320 6148 1042
1 3 1503 2657 3648
1 6 3648 1869 2488 2818 6122 3230
1 4 1503 3929 1627 6053
1 6 6053 895 6019 416 2687 5906
1 5 5906 703 2926 5968 1874
1 5 2789 2140 1536 691 5906
1 4 2789 5856 5871 485
1 4 2789 1942 2274 1277
1 4 444 3878 3285 1277
1 4 3918 6291 264 1508
1 7 1508 6253 2289 6237 3067 6233 755
1 4 1508 6226 2257 6196
1 5 6196 462 1602 6142 6120
1 4 6120 6124 2717 19
1 4 19 6084 3888 2672
1 3 2672 1087 6027
1 2 2672 3148
1 5 2013 2694 1812 309 3148
1 7 2013 3127 554 5841 621 5800 2151
1 8 2151 5800 5774 5746 2440 3457 5627 199
1 4 199 83 5540 5517
1 6 5517 2648 31 283 1387 1368
1 7 917 599 2751 5402 858 3518 1368
1 7 917 3813 2310 1488 3928 5546 5568
1 6 5568 3659 4 2947 5470 5443
1 5 322 5641 2977 1077 5568
1 5 322 1788 111 2485 5806
1 5 5806 1308 5839 5873 5878
1 4 5806 98 3555 804
1 5 5982 2131 5919 3419 804
1 6 5982 1026 643 6063 2988 2949
1 5 2949 6129 2680 6143 1881
1 7 2949 2195 6136 6134 1088 1363 755
1 7 2949 2708 3633 1333 522 1860 2380
1 6 2380 611 6037 1468 6058 6080
1 4 770 1290 2589 6080
1 5 2380 3897 2094 3167 5944
1 7 322 5677 1352 202 2311 11 5718
1 3 5718 581 834
1 4 834 5808 884 192
1 4 192 1848 5861 297
1 4 297 5833 1243 5768
1 7 834 5777 5760 109 1907 487 3186
1 3 3160 3770 5807
1 5 5807 3446 954 1538 5768
1 6 5575 263 2980 2145 579 3160
1 7 5575 1997 5537 5514 5486 3515 5474
1 5 5575 2702 5578 1008 3181
1 5 281 3381 3572 5618 3186
1 5 3181 1285 5501 772 1577
1 4 281 2499 2219 5489
1 7 281 3094 2333 929 5417 1052 1481
1 3 1481 5396 2279
1 5 1481 1548 117 1622 1721
1 8 1481 169 5387 1307 3089 2326 2522 5375
1 6 1577 5441 2161 2084 2420 1481
1 4 5944 2512 5902 192
1 6 476 2016 1506 534 3297 3322